RRRRRRRRRD
XXXXXXXXXD
DLLLLLLLLL
DXXXXXXXXX
RRRRRRRRRD
XXXXXXXXXD
DLLLLLLLLL
DXXXXXXXXX
RRRRRRRRRD
XXXXXXXXXD

