XXXXXXXXXX
XRRRRRRRDX
XUXXXXXXDX
XUXXXXXXDX
XUXXXXXXDX
XUXXXXXXDX
XUXXXXXXDX
XUXXXXXXDX
XULLLLLLLX
XXXXXXXXXX